######################B###
###################### ###
###################### ###
###################### ###
###################### ###
###                    ###
##A ######################